"bD" = (/turf/closed/wall,/area/maintenance/bar)
"cU" = (/obj/effect/turf_decal/loading_area{dir = 8; icon_state = "drain"; name = "drain"},/obj/structure/chair/beanbag/green{dir = 8; pixel_x = 2; pixel_y = -2},/obj/effect/decal/cleanable/dirt,/obj/item/cigbutt{pixel_x = -5; pixel_y = -5},/obj/item/cigbutt/roach{pixel_x = 1; pixel_y = 3},/turf/open/floor/grass,/area/maintenance/bar)
"ef" = (/obj/effect/decal/cleanable/dirt/dust,/turf/open/floor/wood,/area/maintenance/bar)
"gw" = (/obj/structure/mineral_door/wood,/turf/open/floor/wood,/area/maintenance/bar)
"gB" = (/obj/effect/turf_decal/loading_area{dir = 8; icon_state = "drain"; name = "drain"},/obj/structure/chair/beanbag/green{dir = 8; pixel_x = 2; pixel_y = -2},/obj/effect/decal/cleanable/dirt,/obj/item/cigbutt/roach,/obj/item/cigbutt/roach,/obj/item/cigbutt/roach,/obj/item/cigbutt/roach{pixel_x = -6; pixel_y = 4},/obj/item/cigbutt{pixel_x = 4; pixel_y = 3},/turf/open/floor/grass,/area/maintenance/bar)
"hQ" = (/obj/structure/mineral_door/wood,/obj/structure/barricade/wooden,/turf/open/floor/wood{icon_state = "wood-broken4"},/area/maintenance/bar)
"ia" = (/obj/structure/flora/junglebush{pixel_x = 16; pixel_y = 5},/obj/effect/decal/cleanable/dirt,/turf/open/floor/grass,/area/maintenance/bar)
"ig" = (/obj/machinery/vending/gato,/turf/open/floor/wood,/area/maintenance/bar)
"iL" = (/obj/effect/decal/cleanable/dirt,/obj/structure/flora/grass/jungle{pixel_x = 12; pixel_y = 7},/turf/open/floor/grass,/area/maintenance/bar)
"iQ" = (/obj/structure/table/wood,/obj/effect/decal/cleanable/dirt,/obj/item/paper/crumpled{pixel_x = -7; pixel_y = 6},/obj/item/paper/crumpled{pixel_x = -1; pixel_y = 0},/turf/open/floor/carpet/purple,/area/maintenance/bar)
"mA" = (/obj/structure/table/wood,/obj/item/storage/fancy/rollingpapers,/turf/open/floor/wood,/area/maintenance/bar)
"mR" = (/obj/effect/decal/cleanable/dirt,/obj/item/stack/sheet/mineral/wood/twenty,/obj/effect/turf_decal/weather/dirt,/turf/open/floor/wood/damturf/broken6,/area/maintenance/bar)
"op" = (/obj/structure/reagent_dispensers/keg/gargle,/turf/open/floor/wood,/area/maintenance/bar)
"oW" = (/obj/machinery/light/small{dir = 4},/obj/effect/decal/cleanable/dirt/dust,/turf/open/floor/wood,/area/maintenance/bar)
"ph" = (/obj/structure/table/wood,/obj/item/storage/fancy/rollingpapers{pixel_x = -3; pixel_y = -2},/obj/item/storage/fancy/rollingpapers{pixel_x = 4; pixel_y = 5},/obj/effect/decal/cleanable/dirt,/turf/open/floor/carpet/purple,/area/maintenance/bar)
"pJ" = (/obj/effect/decal/cleanable/dirt,/turf/open/floor/carpet/purple,/area/maintenance/bar)
"qw" = (/obj/effect/turf_decal/loading_area{dir = 1; icon_state = "drain"; name = "drain"},/obj/effect/decal/cleanable/dirt,/obj/item/trash/candy{pixel_x = 13; pixel_y = -6},/turf/open/floor/grass,/area/maintenance/bar)
"sD" = (/obj/machinery/light/small{dir = 4},/obj/structure/flora/ausbushes/fullgrass,/obj/effect/decal/cleanable/dirt,/turf/open/floor/grass,/area/maintenance/bar)
"tS" = (/obj/machinery/light/small{dir = 8},/turf/open/floor/wood,/area/maintenance/bar)
"tU" = (/turf/open/floor/wood,/area/maintenance/bar)
"uB" = (/turf/template_noop,/area/template_noop)
"vf" = (/obj/effect/decal/cleanable/dirt,/obj/item/cigbutt/roach{pixel_x = -7; pixel_y = -3},/turf/open/floor/carpet/purple,/area/maintenance/bar)
"vR" = (/obj/machinery/vending/boozeomat/all_access,/turf/closed/wall,/area/maintenance/bar)
"vT" = (/obj/structure/table/wood,/obj/item/book/manual/blubbery_bartender,/obj/effect/turf_decal/loading_area{icon_state = "steel_decals10"},/obj/effect/turf_decal/loading_area{dir = 4; icon_state = "steel_decals10"},/turf/open/floor/wood,/area/maintenance/bar)
"wB" = (/obj/structure/flora/ausbushes/fullgrass,/obj/effect/turf_decal/loading_area{dir = 8; icon_state = "drain"; name = "drain"},/obj/effect/decal/cleanable/dirt,/turf/open/floor/grass,/area/maintenance/bar)
"xW" = (/obj/effect/decal/cleanable/dirt/dust,/turf/open/floor/wood/damturf/broken1,/area/maintenance/bar)
"yu" = (/obj/structure/reagent_dispensers/watertank,/obj/effect/decal/cleanable/dirt,/obj/effect/decal/cleanable/cobweb/cobweb2,/turf/open/floor/wood,/area/maintenance/bar)
"Am" = (/obj/effect/turf_decal/loading_area{dir = 1; icon_state = "drain"; name = "drain"},/obj/effect/turf_decal/loading_area{dir = 8; icon_state = "drain"; name = "drain"},/obj/structure/chair/beanbag/green{dir = 8; pixel_x = 2; pixel_y = -2},/obj/effect/decal/cleanable/dirt,/obj/item/cigbutt{pixel_x = -7; pixel_y = -5},/obj/item/cigbutt{pixel_x = 4; pixel_y = 4},/turf/open/floor/grass,/area/maintenance/bar)
"BK" = (/obj/structure/table/wood,/obj/item/reagent_containers/rag,/obj/machinery/light/small{dir = 1},/obj/effect/turf_decal/loading_area{icon_state = "steel_decals10"},/obj/effect/turf_decal/loading_area{dir = 4; icon_state = "steel_decals10"},/turf/open/floor/wood,/area/maintenance/bar)
"BU" = (/obj/machinery/atmospherics/pipe/simple/scrubbers/hidden,/obj/effect/spawner/structure/window/reinforced,/turf/open/floor/plating,/area/maintenance/port/aft)
"BZ" = (/obj/machinery/vending/mealdor,/turf/open/floor/wood,/area/maintenance/bar)
"Cx" = (/obj/effect/decal/cleanable/dirt,/obj/effect/turf_decal/weather/dirt{dir = 1},/turf/open/floor/wood,/area/maintenance/bar)
"CX" = (/obj/effect/decal/cleanable/dirt,/obj/structure/flora/grass/jungle/b{pixel_x = 1; pixel_y = 11},/obj/item/trash/chips{pixel_x = 11; pixel_y = 2},/turf/open/floor/grass,/area/maintenance/bar)
"ER" = (/obj/effect/decal/cleanable/dirt,/obj/structure/flora/grass/jungle{pixel_x = -7; pixel_y = 11},/obj/item/trash/can{pixel_x = -8; pixel_y = -6},/turf/open/floor/grass,/area/maintenance/bar)
"GJ" = (/obj/machinery/atmospherics/pipe/simple/scrubbers/hidden{dir = 5},/turf/closed/wall,/area/maintenance/port/aft)
"Hx" = (/obj/machinery/door/airlock/maintenance,/obj/structure/cable{icon_state = "1-2"},/turf/open/floor/wood,/area/maintenance/port/aft)
"HY" = (/obj/effect/turf_decal/loading_area{dir = 8; icon_state = "drain"; name = "drain"},/obj/structure/chair/beanbag/green{dir = 8; pixel_x = 2; pixel_y = -2},/obj/effect/decal/cleanable/dirt,/obj/item/cigbutt/roach{pixel_x = 4; pixel_y = 5},/turf/open/floor/grass,/area/maintenance/bar)
"Iw" = (/obj/structure/flora/junglebush,/obj/effect/turf_decal/loading_area{dir = 8; icon_state = "drain"; name = "drain"},/obj/effect/decal/cleanable/dirt,/turf/open/floor/grass,/area/maintenance/bar)
"IJ" = (/obj/effect/spawner/structure/window/reinforced,/turf/open/floor/plating,/area/maintenance/port/aft)
"IS" = (/obj/structure/table/wood,/obj/effect/turf_decal/loading_area{icon_state = "steel_decals10"},/obj/effect/turf_decal/loading_area{dir = 4; icon_state = "steel_decals10"},/turf/open/floor/wood,/area/maintenance/bar)
"KG" = (/obj/effect/landmark/xeno_spawn,/turf/open/floor/wood,/area/maintenance/bar)
"KR" = (/obj/effect/decal/cleanable/dirt,/obj/item/cigbutt/roach{pixel_x = -5; pixel_y = 3},/turf/open/floor/carpet/purple,/area/maintenance/bar)
"Lg" = (/obj/effect/decal/cleanable/dirt,/obj/structure/flora/grass/jungle/b{pixel_x = 5; pixel_y = 3},/turf/open/floor/grass,/area/maintenance/bar)
"MD" = (/obj/effect/decal/cleanable/dirt,/obj/effect/turf_decal/weather/dirt,/turf/open/floor/wood,/area/maintenance/bar)
"MP" = (/obj/effect/decal/cleanable/dirt,/obj/item/cigbutt/roach{pixel_x = 3; pixel_y = 6},/turf/open/floor/carpet/purple,/area/maintenance/bar)
"ON" = (/turf/closed/wall,/area/maintenance/port/aft)
"Pq" = (/obj/effect/decal/cleanable/dirt,/obj/item/trash/cheesie{pixel_x = -11; pixel_y = 1},/turf/open/floor/grass,/area/maintenance/bar)
"PE" = (/obj/structure/cable{icon_state = "1-8"},/turf/open/floor/wood,/area/maintenance/bar)
"Ri" = (/obj/structure/flora/junglebush,/obj/effect/decal/cleanable/dirt,/turf/open/floor/grass,/area/maintenance/bar)
"RK" = (/obj/structure/flora/ausbushes/genericbush,/obj/effect/turf_decal/loading_area{dir = 8; icon_state = "drain"; name = "drain"},/obj/effect/decal/cleanable/dirt,/turf/open/floor/grass,/area/maintenance/bar)
"Tz" = (/obj/machinery/hydroponics/soil,/turf/open/floor/plating/dirt/dark,/area/maintenance/bar)
"Ug" = (/obj/machinery/light/small/broken{dir = 8},/obj/effect/decal/cleanable/dirt,/obj/structure/flora/junglebush,/obj/effect/turf_decal/weather/dirt,/turf/open/floor/wood,/area/maintenance/bar)
"UD" = (/obj/machinery/power/apc{areastring = "/area/maintenance/bar"; dir = 1; name = "Maintenance Bar APC"; pixel_y = 24},/obj/structure/cable{icon_state = "0-4"},/turf/open/floor/wood,/area/maintenance/bar)
"UJ" = (/obj/effect/spawner/lootdrop/keg,/turf/open/floor/wood,/area/maintenance/bar)
"UP" = (/obj/machinery/atmospherics/pipe/simple/scrubbers/hidden,/turf/closed/wall,/area/maintenance/port/aft)
"UZ" = (/obj/effect/turf_decal/loading_area{dir = 1; icon_state = "drain"; name = "drain"},/obj/effect/decal/cleanable/dirt,/turf/open/floor/grass,/area/maintenance/bar)
"Vo" = (/turf/open/floor/wood/damturf/broken3,/area/maintenance/bar)
"XM" = (/obj/effect/decal/cleanable/dirt,/obj/structure/flora/grass/jungle/b{pixel_x = -11; pixel_y = 5},/turf/open/floor/grass,/area/maintenance/bar)
"XS" = (/obj/effect/decal/cleanable/dirt,/turf/open/floor/grass,/area/maintenance/bar)
"YQ" = (/obj/structure/table/wood,/obj/item/storage/bag/plants/portaseeder{pixel_x = -10; pixel_y = 2},/obj/effect/decal/cleanable/dirt,/obj/item/seeds/tobacco{pixel_x = 7; pixel_y = 8},/obj/item/seeds/cannabis{pixel_x = 7; pixel_y = 5},/obj/effect/decal/cleanable/cobweb,/turf/open/floor/wood,/area/maintenance/bar)
"ZD" = (/obj/effect/turf_decal/loading_area{dir = 8; icon_state = "drain"; name = "drain"},/obj/effect/decal/cleanable/dirt,/turf/open/floor/grass,/area/maintenance/bar)

(1,1,1) = {"
uBuBONONONONONHxONONUP
uBuBONtUgwtUUDPEBZigUP
uBuBONtUbDefefxWefoWUP
ONONvRtUBKAmUZUZqwUZUP
ONmAtUtUIScUXSERLgXSBU
ONtSKGtUISgBXSXMPqXSBU
ONUJVoopvTHYXSXSiLXSBU
ONbDhQbDbDwBCXiaXSXSBU
ONYQCxyubDZDKRphvfXSUP
ONUgMDmRbDIwMPiQpJsDUP
ONTzTzTzbDRKXSRiXSXSUP
ONONONONONIJIJIJIJONGJ
"}
